22200222
20000200
20000200
20000222
20000002
22200222
00000000
22202022
00202002
00202202
22202002
00202002
00202002
22202002
00000000
00000000