11100111
10000100
10000100
10000111
10000001
11100111
00000000
11101111
00101001
00101001
11101001
00101111
00101001
00101001
11101111
00000000