33300333
30000300
30000300
30000333
30000003
33300333
00000000
33303333
00303003
00303003
33303003
00303333
00303003
00303003
33303333
00000000